_X________
__TT__T___
__TT______
______X___
_T________
______X___
_________T
_____T____