TTTTTTTTTT
__TT__T___
__TT______
_T____X___
_T____X___
_T____X___
T________T
T____T____