__________
__TT______
__TT______
__________
_T________
__________
_X_______T
_____T____